15 15
# # # # # # # # # # # # # # #
# . . . . . . . . . . . . # #
# . . . . . . . . . . . . # #
# # . . . . . . . . . . # # #
# # # . . . . . . . . # # # #
# # # # . . . . . . # # # # #
# # # # # . . . . # # # # # #
# # # # # # . . # # # # # # #
# # # # # . . . . # # # # # #
# # # # . . . . . . # # # # #
# # # . . . . . . . . # # # #
# # . . . . . . . . . . # # #
# . . . . . . . . . . . . # #
# . . . . . . . . . . . . . #
# # # # # # # # # # # # # # #