15 15
# # # # # # # # # # # # # # #
# . . . . . # # # . . . . . #
# . . . . . # # # . . . . . #
# . . . . . # # # . . . . . #
# . . . . . # # # . . . . . #
# . . . . . . . . . . . . . #
# # # # # . . . . . # # # # #
# # # # # . . . . . # # # # #
# # # # # . . . . . # # # # #
# . . . . . . . . . . . . . #
# . . . . . # # # . . . . . #
# . . . . . # # # . . . . . #
# . . . . . # # # . . . . . #
# . . . . . # # # . . . . . #
# # # # # # # # # # # # # # #